推,噓,分數,作者,標題,時間
6,3,3,ohmylove347 (米特巴爾),[問卦] 認為職業無貴賤的人同意女兒去賣嗎？,Sun Aug 23 00:14:35 2020
10,6,4,words2012 (づ′・ω・),"[問卦] 真的希望女友像簡廷芮,好嗎!",Sun Aug 23 02:48:52 2020
3,0,3,wuyiulin (機掰客家人),[問卦] 有沒有AA的八卦？,Sun Aug 23 01:20:35 2020
16,3,13,takase (............),Re,Sun Aug 23 00:09:43 2020
0,0,0,heaven1123c (),[問卦] 八卦是不是又一波精神衰弱操作?,Sun Aug 23 08:55:29 2020
3,2,1,seanidiot (idiot),Re,Sun Aug 23 00:28:07 2020
103,36,67,relax911 (Lmerro),[新聞] 駁彰化「多做一點不會怎樣」 陳時中：偽,Sun Aug 23 04:36:48 2020
7,0,7,foreverthink (曹雞拜振恰倪嵐),[問卦] 08-16 是不是舔中仔最快樂的時光？,Sun Aug 23 01:48:34 2020
4,3,1,GrexJosh (失去以後才明白曾經擁有),[問卦] 麥當勞早餐的漢堡怎麼比平常時段的好吃?,Sun Aug 23 06:38:08 2020
5,14,-9,waymayday (不要問),[新聞] 韓國瑜明現身 韓粉嗨問：何時感恩之旅？,Sun Aug 23 00:17:42 2020
10,4,6,Ximcra ( ),[問卦] 最近怎麼八卦板又開始又賤畜支那來亂啊?,Sun Aug 23 03:24:51 2020
2,15,-13,rockiey (Sun_flower),[問卦] 法官的住家地址該公開透明嗎？,Sun Aug 23 07:50:47 2020
7,4,3,odd5566 (歐底迪),[問卦] 怎樣認識uber妹子?,Sun Aug 23 07:49:34 2020
3,0,3,SeaForest (~海森林~),Re,Sun Aug 23 01:45:33 2020
8,7,1,teddy98 (泰迪!走吧!),[問卦] 中共派兵來台，待在家最安全?,Sun Aug 23 00:46:50 2020
1,2,-1,RLAPH (川尻浩作),Re,Sun Aug 23 01:55:11 2020
6,4,2,thewtf (濱邊美波我老婆),[問卦] 大家會喜歡小奶女生嗎,Sun Aug 23 08:44:08 2020
8,2,6,Mews (On Your Own),[問卦] 燈泡要壞不壞的要怎辦？,Sun Aug 23 02:55:56 2020
4,4,0,epson5566 (ep),[問卦] 台南學生是吃到爐渣才考不好的嗎?,Sun Aug 23 00:10:07 2020
5,0,5,cwh0105 (Ex咖哩棒),[問卦] 除役就真的除役了嗎?,Sun Aug 23 00:08:50 2020
5,2,3,jis0077 (一個人的輕旅行),[問卦] 台灣為何要花那麼多錢買F16,Sun Aug 23 00:32:41 2020
11,27,-16,cowardlyman (有功夫無懦夫),[問卦] 這女的這麼婊，為什麼男的願意復合？,Sun Aug 23 06:13:38 2020
5,6,-1,howard24 (howtw24),[問卦] 新店被說是南部人,Sun Aug 23 00:34:34 2020
1,0,1,breathair (混口飯吃是理念不同才會1),Re,Sun Aug 23 04:03:34 2020
33,9,24,GhostFather (鬼父Oni Chichi),[問卦]女神願意跟你做愛但條件4吃她大便 願意嗎,Sun Aug 23 01:33:18 2020
5,3,2,ocaca (ocaca),[問卦] 長輩酗酒不吃飯 有辦法送醫嗎,Sun Aug 23 03:10:12 2020
10,4,6,eddisontw (沙丘),[新聞] 阿姨都不來洗頭了！疫情衝擊髮廊業績掉一,Sun Aug 23 07:35:56 2020
6,6,0,HayamaKami (台大彭于晏),[問卦] 肥宅睡不著都吃什麼宵夜,Sun Aug 23 01:06:30 2020
6,2,4,breakofdawn (hi),[新聞] 大陸與印尼建立人員「快捷通道」 可縮短,Sun Aug 23 01:15:52 2020
12,1,11,whiteadam (blue eyes blue),[問卦] 如果突然發現朋友拍裸體寫真,Sun Aug 23 02:22:30 2020
6,3,3,Sibelius26 (SaM),[問卦] 蔡波能跟愛莉莎莎誰比較可愛（一定要選）,Sun Aug 23 00:50:26 2020
6,5,1,than09138 (tony wu),[問卦] 大家嫌房價高可是還一堆人在買？,Sun Aug 23 00:37:49 2020
0,0,0,winnabe (請你不要迷戀哥),[問卦] 阿館是怎樣爆紅的？,Sun Aug 23 08:58:51 2020
0,0,0,ianlin1216 (伊恩可可),[問卦] 書上面寫閱覽注意是什麼意思 ,Sun Aug 23 08:31:53 2020
11,10,1,gaiaesque (一起來聽techno八 o'_'o),[問卦] 嘔嘔嘔 o'_'o,Sun Aug 23 00:25:59 2020
13,4,9,surimodo (搖滾少女!! 活力棉花糖!!),[問卦] 一直洗爐渣是不是想掩蓋什麼,Sun Aug 23 00:56:09 2020
15,10,5,alchemist106 (傳說中的煉金術師),[問卦] 壽喜燒其實就是很鹹的火鍋吧(扭動),Sun Aug 23 01:53:22 2020
3,0,3,a111111 ( ),[問卦] 神奇的拔罐？,Sun Aug 23 00:33:54 2020
1,1,0,a828203 (),[新聞] 聯發科領航 衛星概念股起飛,Sun Aug 23 07:08:02 2020
70,2,68,XXXXHAY (過氣ID),[問卦] 韓漫有能看的嗎,Sun Aug 23 01:38:22 2020
3,5,-2,wandallin (萬大林),[問卦] 2020真的很衰的八卦,Sun Aug 23 02:46:31 2020
6,4,2,cheinshin (那就這樣吧),[問卦] 朋友的兒子上補習班補數學 成績卻退步？,Sun Aug 23 01:38:43 2020
2,1,1,v89074 (Formosan),[問卦] 感覺很多的紛擾都是由愛我們的鄰居惹的,Sun Aug 23 06:17:03 2020
3,1,2,simon78410 (),[問卦] 學伴腿毛很長,Sun Aug 23 00:17:20 2020
1,0,1,ternway (do my part),[新聞] 經濟學人：科技公司上市潮正推動IPO革新,Sun Aug 23 08:01:49 2020
10,13,-3,HisVol (他的體積),[新聞] 估中國2030年GDP超美　林毅夫：美國想打,Sun Aug 23 07:57:41 2020
5,0,5,notfound0506 (存在の証明),[問卦] 60年代的樂團是不是現在樂團的起點,Sun Aug 23 00:08:37 2020
0,0,0,llgod (Wryyyyyyyy),[問卦] 為何有人看到支語就?,Sun Aug 23 08:56:53 2020
2,2,0,LiuLianDan (劉憐誕),[問卦] 叫賣哥還有在夜市叫賣嗎,Sun Aug 23 00:02:51 2020
2,0,2,gk1329 (),[問卦] 地瓜葉的地瓜很好吃?,Sun Aug 23 08:19:13 2020
11,2,9,Xavierk (眼睛紅紅),[問卦] 畢業立馬上考銀行行員好嗎?,Sun Aug 23 00:11:54 2020
59,7,52,deepdish (Keep The Faith),[新聞] 台南情色大樓多次取締無效？按摩女向市,Sun Aug 23 00:33:28 2020
2,1,1,songgood (ilovegoodgame),Re,Sun Aug 23 08:43:40 2020
3,1,2,elite9q (),[問卦] 有比較空的遊樂園嗎?,Sun Aug 23 01:45:27 2020
1,14,-13,norvasc (Norton),[問卦] 鄉民能不能給台灣IU 愛莉莎莎 一點尊重,Sun Aug 23 07:19:16 2020
16,1,15,TVman (電視兒童),[問卦] 王晶跟邱淑貞是權勢交往還是才華真愛,Sun Aug 23 06:59:37 2020
15,12,3,edwardsyo (愛德華),[問卦] 美國認真打會多強,Sun Aug 23 00:53:43 2020
68,50,18,breez (微風),[新聞] 陳時中指偽陽性 學者酸採檢國家都笨蛋? ,Sun Aug 23 08:02:40 2020
0,1,-1,words2012 (づ′・ω・),Re,Sun Aug 23 02:33:06 2020
3,2,1,end56 (終結56),[問卦] 被暗戀對象發現自己家裡蹲怎辦,Sun Aug 23 00:15:30 2020
4,0,4,yachungyu (棒賽看報紙),[問卦] 另一半是金城武是什麼感覺？,Sun Aug 23 02:52:53 2020
14,0,14,olctw (facebook.com/k.olc.tw),Re,Sun Aug 23 02:13:45 2020
8,14,-6,tom282f3 (好的 中國共產黨肺炎),[問卦] PTT剛斷線 怎麼惹,Sun Aug 23 05:15:40 2020
4,3,1,afacebook (gg),Re,Sun Aug 23 08:07:49 2020
1,0,1,jeanvanjohn (尚市長),Re,Sun Aug 23 08:15:38 2020
3,0,3,Thaichonburi (Hello 你好嗎 衷心感謝),Re,Sun Aug 23 08:46:38 2020
5,0,5,a828203 (),[問卦] 為什麼現在沒看到etoro的youtube廣告了?,Sun Aug 23 07:28:00 2020
36,0,36,qazsedcft (自由羊),[新聞] 不再「永遠正確」，金正恩承認朝鮮五年,Sun Aug 23 05:37:03 2020
21,3,18,WuDunE (GLAUCUS),[問卦] 其他國家怎麼處理偽陽性啊,Sun Aug 23 08:07:58 2020
2,0,2,aynmeow (我想成為安康魚),Re,Sun Aug 23 00:08:00 2020
9,1,8,KSHLO (Wunderbar),[問卦] 厄本能逆轉整部電影嗎,Sun Aug 23 02:29:24 2020
2,3,-1,soulboy330 (stay the course),[問卦] 台藝大跟北藝大哪個好啊？,Sun Aug 23 00:05:58 2020
4,2,2,ymx3xc (多多),[問卦] 如果有一天我有了大肚楠 你是否會愛我依,Sun Aug 23 01:35:46 2020
66,8,58,Ho1liday (江湖唯有英雄志),[問卦] 如何一句話激怒中國人？,Sun Aug 23 02:52:31 2020
7,1,6,markban (馬克白),Re,Sun Aug 23 08:22:26 2020
18,2,16,ncc5566 (政大宅男),[問卦] 半澤直樹2給民視拍會怎麼樣??,Sun Aug 23 06:58:56 2020
0,0,0,ianlin1216 (伊恩可可),[問卦] 窮人真的爛命一條不怕死？,Sun Aug 23 06:56:44 2020
221,63,158,davidkobe (david),Re,Sun Aug 23 01:13:41 2020
2,17,-15,GreenBeret (綠扁帽),[問卦] 艾莉莎莎不輸黑嘉嘉吧,Sun Aug 23 00:42:43 2020
6,1,5,w510048 (黨的恩情比山高),Re,Sun Aug 23 01:15:51 2020
11,3,8,fun5566 (裱高中化學題目出錯之神),[新聞] 大學畢業卻騙「只念到高中」 他公務員當2,Sun Aug 23 03:38:57 2020
1,0,1,jensheng09 (甲甲都從後面來),Re,Sun Aug 23 00:17:56 2020
5,2,3,cccyyy104 (Don't get in my way),[問卦] 愛莉莎莎公關文又開始了？,Sun Aug 23 00:13:38 2020
3,13,-10,onetwogo (中國訊息報告工(正確版)),Re,Sun Aug 23 02:20:18 2020
6,0,6,brokenlin (勃肯李),[問卦] 水湳市場沒有好吃的早餐嗎,Sun Aug 23 07:36:47 2020
9,3,6,YummyYummy (優米平方 好想吃大腸),[問卦] 金村美玖要拿多少封面才甘心阿後？,Sun Aug 23 00:14:35 2020
2,1,1,cuba391156 (cuba391156),[問卦] 越野跑是不是很好玩？,Sun Aug 23 08:01:22 2020
13,0,13,paulabxz123 (優文大師),Re,Sun Aug 23 01:51:47 2020
1,0,1,ltyintw (菈米雅嘶嘶),Re,Sun Aug 23 01:43:46 2020
1,5,-4,sunarmed (彰引),[問卦] 可以請喬魯諾把Notorious收一收嗎,Sun Aug 23 02:04:12 2020
1,0,1,homerun2005 (阿里山下智久),Re,Sat Aug 22 23:55:17 2020
15,6,9,lovecyfen (lovecyfen),[問卦] 為何中國不擔心台灣打過去???,Sun Aug 23 01:07:12 2020
6,3,3,vv22hh (v2h),[問卦]  megadownloader 是不是壞了,Sun Aug 23 01:05:10 2020
8,1,7,ifromtaiwan (),[問卦] 仲介一直要我裝電錶,Sun Aug 23 06:39:57 2020
5,9,-4,autechre (Untilted),[問卦] 支那臨幸過的國家是不是只有台灣恨支那?,Sun Aug 23 04:46:17 2020
5,2,3,wuyiulin (機掰客家人),Re,Sun Aug 23 04:32:21 2020
3,11,-8,alphaleomax (阿法Q6號),［問卦］不小心看到隔壁太太的胸部,Sun Aug 23 03:08:33 2020
4,0,4,foreverthink (曹雞拜振恰倪嵐),Re,Sun Aug 23 00:30:06 2020
6,4,2,febula (febula),[問卦] 如果家人託你買彩劵，結果中了一億會講嗎,Sun Aug 23 02:55:40 2020
2,0,2,rfvujm (Rfvujm),Re,Sun Aug 23 07:26:57 2020
18,2,16,RLAPH (川尻浩作),[問卦] 等等表妹要來家裡 要注意什麼？,Sun Aug 23 08:02:12 2020
7,20,-13,Rrrxddd (有噴工讀生 RR),[問卦] 灣灣都用啥軟件 看視頻？,Sun Aug 23 01:12:33 2020
3,1,2,MiLuDaiBoom (ⓂⓛⓁⓤⒹⓐⓛⒷⓞⓞⓂ),[問卦] 一早精神很好要幹嘛,Sun Aug 23 08:24:10 2020
10,75,-65,onetwogo (中國訊息報告工(正確版)),Re,Sun Aug 23 00:35:59 2020
2,0,2,kuangjc5566 (匡匡56),[問卦] 有沒有陳鈺琪的八卦？,Sun Aug 23 01:00:45 2020
15,1,14,LukeSkywaker (路克天醒者),[問卦] 現在學校畢業典禮還有唱周華健的朋友嗎？,Sun Aug 23 00:16:32 2020
6,1,5,ElizabethXIV (應許),[問卦] 寫遺書還讓大家都知道是什麼概念,Sun Aug 23 01:43:47 2020
8,0,8,takashi01 (中和孔劉),[問卦] 沒辦法幫帕瓦報仇了怎辦？？,Sun Aug 23 00:47:28 2020
2,2,0,words2012 (づ′・ω・),[問卦] 你們聽過最恐怖的鬼故事?,Sun Aug 23 01:32:53 2020
2,0,2,buzu (),[新聞] 豪雨大小落石擋路！男子冒雨搬除,Sun Aug 23 00:12:48 2020
11,8,3,shawnfu (差不多先生),[問卦] 現在年輕人還會用XD嗎,Sun Aug 23 03:56:35 2020
22,0,22,PrinceKanto (生田絵梨花は俺の嫁),Re,Sun Aug 23 00:41:35 2020
163,33,130,lovecyfen (lovecyfen),[問卦] 川爸是不是近五十年最威的美國總統?,Sun Aug 23 01:34:35 2020
92,0,92,PrinceKanto (生田絵梨花は俺の嫁),[問卦] 坂道系列現在最慘是哪一期?,Sun Aug 23 00:58:14 2020
29,5,24,zeff (Zeff),[問卦] 突然心情很差怎麼辦,Sun Aug 23 01:46:52 2020
6,10,-4,a6000200 (aa),[新聞] 女追男不成發生爭執　人夫喊冤：我都結婚,Sun Aug 23 01:08:12 2020
31,23,8,HANASUCIA (HANASUCIA),[新聞] 被批刻薄寡恩 柯文哲：沒有想到台灣會變,Sun Aug 23 08:02:54 2020
5,3,2,paulabxz123 (優文大師),[問卦] 慟！學妹說我是LKK！！！怎麼辦？,Sun Aug 23 00:07:22 2020
6,7,-1,aher2600 (和),"[問卦] 有種賭博,大家會不會有興趣?",Sun Aug 23 07:37:23 2020
9,2,7,kkk1234 (Marylin4life),[問卦] 各位手機充電會拆掉保護殼嗎,Sat Aug 22 23:53:39 2020
10,4,6,ian1107 (高雄姜大聲),[問卦] 陶喆哪首歌最經典?,Sun Aug 23 01:34:13 2020
27,26,1,disgusting (噁心的),[問卦] 美國真的打不贏中國,Sun Aug 23 00:21:35 2020
27,3,24,amoyui (clom),[問卦] 為啥台灣海軍不是最強??,Sun Aug 23 02:39:08 2020
8,1,7,s930406 (你啊罵),[問卦] 台酒三杯雞新口味也太難吃了吧,Sun Aug 23 04:09:08 2020
3,0,3,wuyiulin (機掰客家人),Re,Sun Aug 23 00:34:21 2020
2,0,2,miss80423 (自宅警備員),[問卦] 驚！AKB48 TTP要辦兩週年演唱了？,Sat Aug 22 23:56:02 2020
17,2,15,pp771017 (橫艾),[問卦] 邱淑貞是怎麼堅持不露點拍片的？,Sun Aug 23 06:44:10 2020
0,2,-2,damingli90 (子瑜的大腿<3),[問卦] 真的有人出門是為了看女生腿嗎？,Sun Aug 23 01:35:07 2020
1,2,-1,abc0312 (ABC),Re,Sun Aug 23 06:51:16 2020
4,0,4,huabandd (我是阿肥巴你頭),Re,Sun Aug 23 07:24:46 2020
4,4,0,aure0914 (tunik),Re,Sun Aug 23 00:55:39 2020
24,0,24,flower42 (栗悟飯與龜波功),[問卦] 世紀帝國哪個戰役最經典？,Sun Aug 23 01:48:42 2020
8,2,6,Xing97302 (幹古專用帳號粉絲),[問卦] 無法定義合法性專區 何不反其道而行,Sun Aug 23 00:59:44 2020
16,27,-11,AUTIS (Autis),[新聞] 柯文哲：台北如果普篩 全國跟著做就對了,Sun Aug 23 01:16:21 2020
8,1,7,zkow (逍遙山水憶秋年),[問卦] 現在社會對不正當男女關係接受度包容力高,Sun Aug 23 01:42:27 2020
14,2,12,cclemonmen (cclemon),[問卦] 山雞在古惑仔各集最帥的時候是啥時,Sun Aug 23 00:01:26 2020
4,2,2,u35k6 (漫畫),Re,Sun Aug 23 08:43:23 2020
4,2,2,badbadook (嗨浪),[問卦] drg是不是屌打s妹,Sun Aug 23 07:12:43 2020
0,18,-18,GreenBeret (綠扁帽),Re,Sun Aug 23 00:49:54 2020
24,7,17,ccf52881 (ccf52881),[新聞] 影／民眾黨多項選舉慘敗 柯文哲認光環失,Sun Aug 23 08:26:14 2020
8,5,3,boing747 (freedom￾N￼ ),Re,Sun Aug 23 03:39:30 2020
0,0,0,leavez (XD),Re,Sun Aug 23 00:35:32 2020
8,3,5,seysem (seysem),[新聞] 車拋錨！警幫停車　女駕駛：停車格會收費,Sun Aug 23 01:47:18 2020
1,0,1,toolmaster (工具人大師),[問卦] 人類是不是一定有近視？,Sun Aug 23 08:30:43 2020
1,2,-1,Tacohan (台南彭于晏),[問卦] 回憶跟錢 都幾,Sun Aug 23 00:39:11 2020
4,0,4,herman5202 (李白),Re,Sun Aug 23 08:38:13 2020
5,1,4,WeiU (微，Ｕ文),[問卦] 會在ktv吸菸的都哪種人????,Sun Aug 23 00:31:54 2020
9,2,7,w510048 (黨的恩情比山高),[問卦] 人形兵器為何這麼難以駕駛?,Sun Aug 23 01:06:09 2020
11,3,8,lianpig5566 (家庭教師殺手里包恩),[問卦] 大學打工是為了經驗還是零用錢,Sun Aug 23 02:24:58 2020
0,0,0,join183club (183club),Re,Sun Aug 23 08:46:14 2020
8,3,5,xxxd851130 (宇智波警備隊隊長),[問卦] 如果剛入伍第一天就都不講話,Sun Aug 23 00:52:29 2020
19,0,19,Ifault (Not my fault),[問卦] 華人最推崇或最惋惜的失敗者是誰？,Sun Aug 23 01:55:29 2020
2,3,-1,youarenotgay (你並不快樂),[問卦] 大家都有看過室友的屁眼毛嗎？,Sun Aug 23 00:46:10 2020
3,2,1,kt40 (零分朋友),[問卦] 中國lol女主播到底在講三小,Sun Aug 23 00:39:57 2020
8,0,8,muse87131 (),[新聞] 新冠病毒疫情永遠不會消失,Sun Aug 23 07:22:38 2020
5,0,5,Ifault (Not my fault),[問卦] 惠比壽麝香葡萄 很冷門嗎？,Sun Aug 23 05:15:29 2020
14,32,-18,z770808 (),[新聞] 民眾嗆問兩岸問題 馬英九：常說謊的人未,Sun Aug 23 08:32:21 2020
0,3,-3,Nigger5566 (尼哥56),[問卦] nmsmusic是什麼板,Sun Aug 23 01:34:31 2020
6,5,1,peterpan0228 (haveapen),[問卦] 有沒有牙套妹的八卦,Sun Aug 23 02:37:12 2020
18,0,18,sam09 (柊鏡),Re,Sun Aug 23 02:45:06 2020
4,4,0,a111111 ( ),Re,Sun Aug 23 00:53:12 2020
3,2,1,eachen (易陳),[問卦] 臭豆腐用烤用炸用煮那種好吃,Sun Aug 23 00:51:21 2020
9,7,2,KasmirLo (科科科~),[問卦] 看火刑心理素質要多高,Sun Aug 23 01:17:09 2020
0,0,0,homerun2005 (阿里山下智久),Re,Sun Aug 23 08:50:26 2020
1,0,1,CORSA (重型爬行獸),Re,Sun Aug 23 00:16:07 2020
7,8,-1,a6000200 (aa),[問卦] 擔誤女生vs單身,Sun Aug 23 02:06:38 2020
2,3,-1,FL5566 (小魯妹),Re,Sun Aug 23 00:05:07 2020
5,2,3,ms0286415 (ms0286415),[問卦] 是不是幾乎的人都是這樣啊??,Sun Aug 23 00:13:14 2020
4,8,-4,santan (光與灰燼),[新聞] 小鮮肉澎湖裸身激戰 刺痛感像極愛情,Sun Aug 23 02:35:24 2020
1,1,0,Lineage097 (狐狸壽司),Re,Sun Aug 23 00:08:23 2020
119,30,89,yuahang (橘花貓),[新聞] 德國首席病毒學家建議終止機場的新冠檢測,Sun Aug 23 05:21:51 2020
34,10,24,LoveMakeLove (ボケ),[新聞]劉寶傑捅到馬蜂窩 館長死咬：要戰大家來戰,Sun Aug 23 07:37:33 2020
9,6,3,j9966330k (白玉樓的廁所),[問卦] 這裡有人會對對子嗎（在線急,Sun Aug 23 01:49:22 2020
15,1,14,Triceratops (Jurassic),[新聞] 美國警察手抬3000磅轎車 救出被壓男子,Sun Aug 23 00:18:54 2020
14,1,13,seand8088503 (あいうえお),[問卦] 在蝦皮評論區露鳥的都是哪種人啊？！,Sun Aug 23 01:32:41 2020
1,3,-2,ga86041 (ga86041),Re,Sun Aug 23 04:43:38 2020
1,1,0,mystage (亭),Re,Sun Aug 23 07:24:41 2020
6,0,6,bota (llll),[問卦] 波蘭翼騎兵存在的時間不如武田赤備?,Sun Aug 23 01:44:07 2020
4,9,-5,hiimlove (樂樂),[問卦] 新品種約克洋？,Sun Aug 23 02:09:13 2020
2,16,-14,tsaiss (Samkh),[問卦] 早上七點搭高鐵現在睡不著怎麼辦？,Sun Aug 23 03:43:27 2020
3,5,-2,Rimi5566 (布口以欺付里美),[爆卦] 林書豪葛葛今天生日,Sun Aug 23 00:08:20 2020
31,0,31,ea000382 (肥宅),[問卦] 被汽車撞  求償多少算合理,Sun Aug 23 00:22:31 2020
4,3,1,ayaneoshi (小坂菜緒は俺の嫁),[問卦] 日向坂46新的演出服很好看！？,Sun Aug 23 02:32:39 2020
2,0,2,Kulapica (酷拉皮卡),Re,Sun Aug 23 08:16:12 2020
71,23,48,LIN9 (LIN9),[新聞] 劉樂妍找台灣人去中國工作 待遇曝光被狂,Sun Aug 23 07:20:03 2020
4,2,2,martin110287 (廢文權威),[新聞],Sun Aug 23 00:21:42 2020
8,1,7,cowardlyman (有功夫無懦夫),[問卦] 龜仙人這麼好色，怎麼一個後代都沒有？,Sun Aug 23 03:34:41 2020
14,6,8,bota (llll),[問卦] 我們中國古代怎麼沒有發展出長槍陣?,Sun Aug 23 02:01:52 2020
3,0,3,deepdish (Keep The Faith),[問卦] 有沒有Slacktivism 懶人行動主義的八卦？,Sun Aug 23 00:52:18 2020
3,0,3,aher2600 (和),Re,Sun Aug 23 06:42:15 2020
5,2,3,pennyleo (今朝有酒今朝醉),[問卦] 有沒有超級性冷感的八卦,Sun Aug 23 07:59:55 2020
2,4,-2,Ninja650r (忍者),[問卦] 房東的水電費其實都是房客在繳？,Sun Aug 23 01:32:45 2020
8,6,2,ainor (><),Re,Sun Aug 23 00:08:22 2020
3,0,3,ck5 (逆時針),Re,Sun Aug 23 00:57:22 2020
5,8,-3,humorchou (月亮不睡我不睡),[問卦] 急！被困在陽台怎麼辦,Sun Aug 23 04:11:30 2020
3,3,0,devidevi (凱特),Re,Sun Aug 23 00:03:15 2020
7,7,0,ht91008 (色情狂),Re,Sun Aug 23 03:20:09 2020
1,0,1,gerychen (邪惡肥宅),[問卦] 沿著氣味一路追逐？,Sun Aug 23 00:07:59 2020
3,0,3,rfvujm (Rfvujm),Re,Sun Aug 23 07:44:07 2020
6,4,2,andycheng60 (andycheng),Re,Sun Aug 23 01:20:29 2020
8,3,5,huabandd (我是阿肥巴你頭),Re,Sun Aug 23 03:35:53 2020
0,1,-1,fuccwoman (帥的亂七八槽),Re,Sun Aug 23 00:33:53 2020
0,0,0,ECZEMA (ID 亂取的啦!),[爆卦] 美國抖音 告 川普政府,Sun Aug 23 08:56:51 2020
12,5,7,whiteadam (blue eyes blue),[問卦] 什麼樣的人會打因該?,Sun Aug 23 02:10:55 2020
0,1,-1,q9154336 (SSB),[問卦] 聖水理容院的,Sun Aug 23 01:03:42 2020
11,6,5,L1ON (我是獅子~(ﾉﾟ▽ﾟ)ﾉ♪),[問卦] 黑人強暴犯都怎樣過生日？,Sun Aug 23 05:23:40 2020
2,0,2,Cyborg (廢問只能一篇),Re,Sun Aug 23 03:48:03 2020
20,6,14,jis0077 (一個人的輕旅行),[新聞] 殘忍狙殺海盜影片瘋傳 大陸籍船長入高雄,Sun Aug 23 00:14:09 2020
5,5,0,paulabxz123 (優文大師),[問卦] 涕涕剃光頭,Sun Aug 23 00:51:18 2020
0,4,-4,z0953781935 (妹妹罵我是肥豬>///<),[問卦] 一夫一妻制是不是造成很多悲劇？,Sun Aug 23 00:05:02 2020
15,8,7,ltyintw (菈米雅嘶嘶),[問卦] 各縣市的貶稱是什麼,Sun Aug 23 00:45:10 2020
1,0,1,heisaboyo (heisaboyo),[問卦] 這種人都是什麼心態?,Sun Aug 23 02:43:10 2020
18,5,13,FL5566 (小魯妹),[問卦] 美國賣台灣最強淺水艇不就解決了??,Sun Aug 23 00:57:33 2020
13,5,8,RocktheBeat (席爾薇雅俺の嫁),[問卦] 半夜有網友願意幫我送餐很暖嗎,Sun Aug 23 02:15:21 2020
49,5,44,Rossini (威廉泰爾),[新聞] 男子午睡突被壓醒 驚見一頭母獅趴胸口狠瞪,Sun Aug 23 01:17:25 2020
28,7,21,CHL98 (CHL),[新聞] 來台檢舉盜版AV！日籍男遭球棒狂毆…法院,Sun Aug 23 04:38:21 2020
1,0,1,ht91008 (色情狂),Re,Sun Aug 23 02:17:52 2020
8,1,7,Changyaya (),Re,Sun Aug 23 02:15:31 2020
8,36,-28,gentleman888 (),[新聞] 民進黨鐵腕逐客 陸生改赴英怨像次等人,Sun Aug 23 08:04:52 2020
7,1,6,gn01982667 (冬瓜茶),[問卦] 30歲的服務業存款多少合格？,Sun Aug 23 02:18:42 2020
14,3,11,Dinenger (低能兒),Re,Sun Aug 23 01:47:09 2020
8,2,6,takashi01 (中和孔劉),[問卦] 手機桌布會放自己的本命嗎？,Sun Aug 23 00:11:57 2020
21,3,18,tony900735 (好貴！  好貴！),[問卦] 台中會發展出怎樣的捷運文化？,Sun Aug 23 05:00:35 2020
13,2,11,Axwell (Axwell),[問卦] 有沒有熵的八卦？,Sun Aug 23 07:54:43 2020
4,3,1,Ninja650r (忍者),[問卦] 美國是不是有實力統一全世界?,Sun Aug 23 00:59:29 2020
9,3,6,seabox (盒盒),[公告] 水桶,Sun Aug 23 01:19:50 2020
10,1,9,Workforme (′‧ω‧‵),[新聞] 向友借錢不還 男竟還嗆「你這條命別想要,Sun Aug 23 06:01:25 2020
4,3,1,kinghole (安),[新聞] 聯合國警告疫情或導致饑荒，公眾囤糧必要,Sun Aug 23 02:19:43 2020
0,0,0,elfria (狠愛演鐵粉),Re,Sun Aug 23 01:54:09 2020
7,0,7,Dinenger (低能兒),Re,Sun Aug 23 02:38:50 2020
8,0,8,bubu26 (白寶),[問卦] 全聯的閃電泡芙在甜食界是什麼地位?,Sun Aug 23 00:17:42 2020
37,7,30,aoku0321 (奧),[問卦],Sun Aug 23 03:57:05 2020
7,1,6,ltyintw (菈米雅嘶嘶),Re,Sun Aug 23 01:21:39 2020
6,8,-2,tml7415 (國民黨不倒 台灣不會好),Re,Sun Aug 23 00:20:43 2020
23,11,12,lianpig5566 (家庭教師殺手里包恩),[問卦] 最近過年越來越沒有年味了,Sun Aug 23 03:12:50 2020
7,2,5,Kulapica (酷拉皮卡),[問卦] 為什麼不販賣快篩試劑一人限購一份,Sun Aug 23 08:49:34 2020
7,6,1,eierom (非),[新聞] 中共加速崩潰…他曝美國恐擔心這件事,Sun Aug 23 07:23:13 2020
9,0,9,sodistrues (true),[問卦] 金庸初版倚天張無忌當峨嵋掌門也太爽？,Sun Aug 23 07:24:53 2020
2,0,2,bwnzer (布 溫瑟),Re,Sun Aug 23 00:41:57 2020
10,5,5,nightwing (內觀自心),[新聞] 民進黨台南辦青年培訓營 賴清德：國家未,Sun Aug 23 07:43:25 2020
4,0,4,loveian16 (),Re,Sun Aug 23 07:36:52 2020
1,6,-5,xvited945 (sk0k0),Re,Sun Aug 23 06:48:14 2020
22,5,17,edwardsyo (愛德華),[問卦] 美國左膠為什麼會舔共,Sun Aug 23 01:39:53 2020
5,5,0,Adamcolton (Coolmint),Re,Sun Aug 23 00:08:05 2020
69,17,52,volcom (優質建商),[問卦] 日本為何要花那麼多錢買F35,Sun Aug 23 00:20:06 2020
12,3,9,a111111 ( ),[問卦] 明朝是怎麼打敗蒙古帝國的？,Sun Aug 23 07:40:06 2020
5,0,5,Greatgenius (雷達 X 守望),Re,Sun Aug 23 03:19:40 2020
2,4,-2,cj3x04gp6 (說散就散 真是難聽到爆),[問卦] 有台灣第一紅歌手陳綺貞的八卦嗎?,Sun Aug 23 08:31:26 2020
1,0,1,a6234709 (永不言棄的肥宅),Re,Sun Aug 23 00:40:22 2020
3,10,-7,A816 (♥七瀬丸的灰太狼♥),[問卦] 八卦的87多到屏蔽不完？,Sun Aug 23 08:34:11 2020
2,1,1,jt13 (MASTER),Re,Sun Aug 23 00:41:28 2020
5,0,5,Sk8erBoi (滑板男孩),[問卦] 為什麼蘿拉一直換人?,Sun Aug 23 00:32:43 2020
1,5,-4,leocean9816 (阿光),[新聞] 73共和黨前官員棄特朗普改挺拜登,Sun Aug 23 00:37:42 2020
38,6,32,JUNOCARE (陽光！！),[問卦] 台灣內鬼有可能自己先從內部開打嗎,Sun Aug 23 01:56:28 2020
6,0,6,miloskyman (削波快),[問卦] 中國打戰是要吃洨嗎,Sun Aug 23 00:37:09 2020
5,2,3,ai40 (墮落),[問卦] 什麼時候才發現自己變得不再健康了,Sun Aug 23 02:55:01 2020
2,0,2,G888888 (廢文產生器),Re,Sun Aug 23 00:51:00 2020
5,33,-28,Tiara5566 (霸凌天團),[新聞] 傻眼！蔡波能出生4個月暴風成長 蔡阿嘎,Sun Aug 23 00:05:08 2020
6,0,6,emperor (派蘿派蘿得第一),[問卦] 与田祐希問我說新買的口紅好看嗎?,Sun Aug 23 00:06:52 2020
0,0,0,bul (腹內原來草莽),Re,Sat Aug 22 23:55:35 2020
5,4,1,autokey (該起床啦),[問卦] 泡友結婚參加喜宴要準備什麼的八卦?,Sun Aug 23 03:26:45 2020
7,39,-32,ota978 (流星),[問卦] 兩岸七十年穩定是不是蔡任內 劃下句點,Sun Aug 23 00:09:38 2020
6,9,-3,norvasc (Norton),[問卦] 為何每篇愛莉莎莎都看得到G軟,Sun Aug 23 00:18:35 2020
11,3,8,kopuck (派翠克星星),[問卦] 科技這三十年快速發展 那醫學呢,Sun Aug 23 08:37:51 2020
0,0,0,laptic (靜夜聖林彼岸花),Re,Sun Aug 23 08:29:03 2020
33,32,1,jis0077 (一個人的輕旅行),[問卦] 日本凌虐過的國家是不是只有台灣愛日本?,Sun Aug 23 00:43:07 2020
9,3,6,mkjay00000 (大隻的肥羊),[問卦] 地下街流行抽一番賞？,Sun Aug 23 01:42:20 2020
3,0,3,Leadkeita (大便完 轉身就走),[問卦] 睡不著覺的時候你會幹嘛？,Sun Aug 23 00:26:00 2020
21,0,21,okalala1234 (牛頓公爵),Re,Sun Aug 23 07:38:13 2020
7,2,5,ktpss95070 (ktpss95070),[問卦] 債留子孫 環保救地球,Sun Aug 23 08:40:58 2020
2,4,-2,xzcb2008 (日本可愛情色貓),Re,Sat Aug 22 23:55:39 2020
9,0,9,asdfg012345 (Vicious circle),[問卦] 台灣人不是怕死！怎麼不改善交通安全,Sun Aug 23 06:57:39 2020
3,0,3,yainman (yainwoman),[問卦] 其實，台灣經濟狀況還不錯吧？,Sun Aug 23 08:21:35 2020
14,0,14,mizuarashi (米茲阿拉西),[問卦] 還有人記得大創案嗎？,Sun Aug 23 00:15:13 2020
14,3,11,Dinenger,[問卦] 欸，爐渣問題其實還好吧？,8/23
6,9,-3,a12141623 (舔舔老二再泡泡茶),[問卦] Kobe的精神是什麼,Sun Aug 23 00:17:46 2020
2,4,-2,funasake (),[問卦] 我們來玩一個遊戲！,Sun Aug 23 01:01:27 2020
6,1,5,rfvujm (Rfvujm),[問卦] 以前的搖飲料娃娃怎麼不見了,Sun Aug 23 08:37:46 2020
9,13,-4,efthu456 (小哲),[問卦] 滑交友軟體滑到自己的堂妹怎麼辦 在線等,Sun Aug 23 03:02:59 2020
8,4,4,GrexJosh (失去以後才明白曾經擁有),[問卦] 為什麼韓國的基督教那麼囂張啊?,Sun Aug 23 02:08:42 2020
10,7,3,simonle (.0.),[新聞] 不做了！彰化居家檢疫無症狀採檢暫停,Sun Aug 23 00:06:53 2020
10,1,9,lpbrother (LP哥(LP = Love & Peace)),[問卦] 大家都有房，那到底是誰在買房？,Sun Aug 23 08:21:36 2020
24,10,14,leon105 (@@),[新聞] 奧客咆哮影城效率差「我要投訴」　店員霸,Sun Aug 23 08:34:06 2020
6,1,5,Sienta (小車大空間),[問卦] 請問台南安定水泥園區土地變更案的八卦,Sun Aug 23 00:51:03 2020
10,20,-10,realtw (realtw),[問卦] 台灣人印象中的中國 廁所沒門?,Sun Aug 23 00:52:08 2020
0,0,0,seabox (盒盒),[公告] 八卦板板規(2020.07.21),Tue Jul 21 00:00:04 2020
7,0,7,st40182 (),[問卦] 有沒有散戶中的霸主的八卦,Sun Aug 23 00:29:57 2020
6,0,6,THINKTAIWAN (想想台灣),[問卦] 有沒有台南冠軍米跟爐渣米的八卦,Sun Aug 23 00:45:37 2020
6,1,5,paulabxz123 (優文大師),Re,Sun Aug 23 01:04:51 2020
11,1,10,Lampaininder ( ),[新聞] 網友批議員段樹文佛地魔 也有人說浪子回,Sun Aug 23 07:11:16 2020
2,1,1,ppppppppp (凹嗚嗚),[問卦] 舉牌子搖旗子的意義,Sun Aug 23 00:42:44 2020
10,3,7,nanachi (上善若水),[問卦] 為什麼日本宅宅多仇韓？,Sun Aug 23 07:43:57 2020
11,2,9,foreverthink (曹雞拜振恰倪嵐),[問卦] 中國的海空軍是不是很幹,Sun Aug 23 00:40:45 2020
11,5,6,gracew0709 (succinyl choline),[問卦] 爐渣市是最棒的☺  我的一天,Sun Aug 23 04:55:51 2020
1,1,0,simon78410 (),[問卦] 月薪多少你才願意去金門生活?,Sun Aug 23 00:05:04 2020
0,0,0,rainjuly (深夜高速),[問卦] 考え事 武道館版,Sun Aug 23 01:18:15 2020
18,5,13,bathilda (bat),[問卦] 姓林的都是俊男美女嗎？,Sun Aug 23 01:00:59 2020
4,0,4,Cyborg (廢問只能一篇),Re,Sun Aug 23 01:58:28 2020
6,0,6,doomdied (Died),[問卦] 有沒有Pan Piano紅到澳門的八卦 ?,Sun Aug 23 00:10:06 2020
15,6,9,aftercome86 (竹炭),[問卦] 拜登是戀童癖嗎?,Sun Aug 23 04:39:32 2020
15,3,12,rocephin (Roce),[問卦] 為何Jolin拍UE廣告 要阿嘿顏？？,Sun Aug 23 08:06:03 2020
13,0,13,ayazard (aya),[問卦] 乃木坂白石麻衣卒業演唱會怎麼喊CALL?,Sat Aug 22 23:55:50 2020
7,1,6,CGDGAD ((CGDGAD)),Re,Sun Aug 23 00:21:06 2020
14,5,9,evy155 (HI~),[問卦] 麥當勞薯條 份量,Sun Aug 23 04:00:40 2020
0,2,-2,Dinenger (低能兒),Re,Sun Aug 23 01:24:46 2020
6,0,6,adf926 (呵呵蓋),[問卦] 等等小妹要去親戚家要注意什麼?,Sun Aug 23 08:26:23 2020
6,2,4,Superxixai (洪粉吱已),[問卦] 相信中共會打過來的人在想什麼？,Sun Aug 23 00:31:30 2020
1,4,-3,ccyaztfe (best_troll_tw),Re,Sun Aug 23 06:54:03 2020
3,5,-2,longyin (龍吟很難嗎？為什麼),Re,Sun Aug 23 06:56:52 2020
11,1,10,APPLEin5566 (泰山下智久),[問卦] 去KTV 要唱什麼歌才可以吸引到妹子?,Sun Aug 23 00:59:36 2020
4,2,2,littlejackbr (liljb),[問卦] 一千萬隻陰蝨同時跳？,Sun Aug 23 01:02:40 2020
